头部	header				ie6 bug			
底部	footer
宏
	超级宏	yylmacro
	新宏库	macro
工具
	工具	tools
	插件	plugin
	WP系统	other
论坛
	侧边	aside
	列表	list
	单页	view
	系统	msg
门户
	列表	list
	单页	view
	首页	index
用户
	导航	nav
	个人	home
	中心	os
	会员	vip
	积分	credit
移动
	微信	wx
	首页	index
副本	
	专题	fb
	论坛	bbs
	招募	raid
	群组	group
休闲
	捏脸	face
	宠物	pet
	抓马	horse
	视频	video
	音乐	music
职业	
	白皮书	role
	题库	exam
